sample_index,label,base_pred,local_pred,final_pred,base_correct,local_correct,final_correct,base_local_agree,base_final_agree,local_final_agree
0,0,2,2,2,0,0,0,1,1,1
1,0,2,2,2,0,0,0,1,1,1
2,0,1,2,1,0,0,0,0,1,0
3,0,1,1,1,0,0,0,1,1,1
4,0,2,2,2,0,0,0,1,1,1
5,1,2,2,2,0,0,0,1,1,1
6,1,2,2,2,0,0,0,1,1,1
7,1,2,2,2,0,0,0,1,1,1
8,1,1,1,1,1,1,1,1,1,1
9,1,2,2,2,0,0,0,1,1,1
10,2,1,1,1,0,0,0,1,1,1
11,2,1,1,1,0,0,0,1,1,1
12,2,1,1,1,0,0,0,1,1,1
13,2,2,2,2,1,1,1,1,1,1
14,2,1,1,1,0,0,0,1,1,1
