sample_index,label,base_pred,local_pred,final_pred,base_correct,local_correct,final_correct,base_local_agree,base_final_agree,local_final_agree
0,0,0,0,0,1,1,1,1,1,1
1,0,0,0,0,1,1,1,1,1,1
2,0,13,13,13,0,0,0,1,1,1
3,0,0,0,0,1,1,1,1,1,1
4,0,0,0,0,1,1,1,1,1,1
5,0,0,0,0,1,1,1,1,1,1
6,0,0,0,0,1,1,1,1,1,1
7,0,0,0,0,1,1,1,1,1,1
8,0,0,0,0,1,1,1,1,1,1
9,0,0,0,0,1,1,1,1,1,1
10,0,0,0,0,1,1,1,1,1,1
11,0,0,0,0,1,1,1,1,1,1
12,1,1,1,1,1,1,1,1,1,1
13,1,1,1,1,1,1,1,1,1,1
14,1,1,1,1,1,1,1,1,1,1
15,1,1,1,1,1,1,1,1,1,1
16,1,1,1,1,1,1,1,1,1,1
17,1,1,1,1,1,1,1,1,1,1
18,1,1,1,1,1,1,1,1,1,1
19,1,1,1,1,1,1,1,1,1,1
20,1,1,1,1,1,1,1,1,1,1
21,1,1,1,1,1,1,1,1,1,1
22,1,1,1,1,1,1,1,1,1,1
23,1,1,1,1,1,1,1,1,1,1
24,2,2,2,2,1,1,1,1,1,1
25,2,2,2,2,1,1,1,1,1,1
26,2,2,2,2,1,1,1,1,1,1
27,2,2,2,2,1,1,1,1,1,1
28,2,2,2,2,1,1,1,1,1,1
29,2,2,2,2,1,1,1,1,1,1
30,2,2,2,2,1,1,1,1,1,1
31,2,2,2,2,1,1,1,1,1,1
32,2,2,2,2,1,1,1,1,1,1
33,2,2,2,2,1,1,1,1,1,1
34,2,2,2,2,1,1,1,1,1,1
35,2,2,2,2,1,1,1,1,1,1
36,3,3,3,3,1,1,1,1,1,1
37,3,3,3,3,1,1,1,1,1,1
38,3,8,3,8,0,1,0,0,1,0
39,3,3,3,3,1,1,1,1,1,1
40,3,3,3,3,1,1,1,1,1,1
41,3,3,3,3,1,1,1,1,1,1
42,3,3,3,3,1,1,1,1,1,1
43,3,3,3,3,1,1,1,1,1,1
44,3,3,3,3,1,1,1,1,1,1
45,3,3,3,3,1,1,1,1,1,1
46,3,3,3,3,1,1,1,1,1,1
47,3,3,3,3,1,1,1,1,1,1
48,4,4,4,4,1,1,1,1,1,1
49,4,4,4,4,1,1,1,1,1,1
50,4,8,8,8,0,0,0,1,1,1
51,4,4,4,4,1,1,1,1,1,1
52,4,4,4,4,1,1,1,1,1,1
53,4,4,4,4,1,1,1,1,1,1
54,4,4,4,4,1,1,1,1,1,1
55,4,4,4,4,1,1,1,1,1,1
56,4,4,4,4,1,1,1,1,1,1
57,4,4,4,4,1,1,1,1,1,1
58,4,4,4,4,1,1,1,1,1,1
59,4,4,4,4,1,1,1,1,1,1
60,5,5,5,5,1,1,1,1,1,1
61,5,5,5,5,1,1,1,1,1,1
62,5,5,5,5,1,1,1,1,1,1
63,5,5,5,5,1,1,1,1,1,1
64,5,5,5,5,1,1,1,1,1,1
65,5,5,5,5,1,1,1,1,1,1
66,5,3,3,3,0,0,0,1,1,1
67,5,5,5,5,1,1,1,1,1,1
68,5,5,5,5,1,1,1,1,1,1
69,5,5,5,5,1,1,1,1,1,1
70,5,5,5,5,1,1,1,1,1,1
71,5,5,5,5,1,1,1,1,1,1
72,6,6,6,6,1,1,1,1,1,1
73,6,6,6,6,1,1,1,1,1,1
74,6,6,6,6,1,1,1,1,1,1
75,6,6,6,6,1,1,1,1,1,1
76,6,6,6,6,1,1,1,1,1,1
77,6,6,6,6,1,1,1,1,1,1
78,6,6,6,6,1,1,1,1,1,1
79,6,6,6,6,1,1,1,1,1,1
80,6,6,6,6,1,1,1,1,1,1
81,6,6,6,6,1,1,1,1,1,1
82,6,6,6,6,1,1,1,1,1,1
83,6,6,6,6,1,1,1,1,1,1
84,7,8,8,8,0,0,0,1,1,1
85,7,7,7,7,1,1,1,1,1,1
86,7,7,7,7,1,1,1,1,1,1
87,7,7,7,7,1,1,1,1,1,1
88,7,7,7,7,1,1,1,1,1,1
89,7,7,7,7,1,1,1,1,1,1
90,7,7,7,7,1,1,1,1,1,1
91,7,7,7,7,1,1,1,1,1,1
92,7,7,7,7,1,1,1,1,1,1
93,7,14,14,14,0,0,0,1,1,1
94,7,7,7,7,1,1,1,1,1,1
95,7,7,7,7,1,1,1,1,1,1
96,8,8,8,8,1,1,1,1,1,1
97,8,8,8,8,1,1,1,1,1,1
98,8,8,8,8,1,1,1,1,1,1
99,8,8,8,8,1,1,1,1,1,1
100,8,8,8,8,1,1,1,1,1,1
101,8,8,8,8,1,1,1,1,1,1
102,8,8,8,8,1,1,1,1,1,1
103,8,8,8,8,1,1,1,1,1,1
104,8,8,8,8,1,1,1,1,1,1
105,8,8,8,8,1,1,1,1,1,1
106,8,8,8,8,1,1,1,1,1,1
107,8,8,8,8,1,1,1,1,1,1
108,9,11,11,11,0,0,0,1,1,1
109,9,9,9,9,1,1,1,1,1,1
110,9,9,9,9,1,1,1,1,1,1
111,9,11,11,11,0,0,0,1,1,1
112,9,11,11,11,0,0,0,1,1,1
113,9,9,9,9,1,1,1,1,1,1
114,9,9,9,9,1,1,1,1,1,1
115,9,9,9,9,1,1,1,1,1,1
116,9,9,9,9,1,1,1,1,1,1
117,9,9,9,9,1,1,1,1,1,1
118,9,9,9,9,1,1,1,1,1,1
119,9,9,9,9,1,1,1,1,1,1
120,10,10,10,10,1,1,1,1,1,1
121,10,10,10,10,1,1,1,1,1,1
122,10,10,10,10,1,1,1,1,1,1
123,10,10,10,10,1,1,1,1,1,1
124,10,10,10,10,1,1,1,1,1,1
125,10,10,10,10,1,1,1,1,1,1
126,10,10,10,10,1,1,1,1,1,1
127,10,10,10,10,1,1,1,1,1,1
128,10,10,10,10,1,1,1,1,1,1
129,10,10,10,10,1,1,1,1,1,1
130,10,10,10,10,1,1,1,1,1,1
131,10,10,10,10,1,1,1,1,1,1
132,11,11,11,11,1,1,1,1,1,1
133,11,11,11,11,1,1,1,1,1,1
134,11,11,11,11,1,1,1,1,1,1
135,11,11,11,11,1,1,1,1,1,1
136,11,11,11,11,1,1,1,1,1,1
137,11,11,11,11,1,1,1,1,1,1
138,11,11,11,11,1,1,1,1,1,1
139,11,11,11,11,1,1,1,1,1,1
140,11,11,11,11,1,1,1,1,1,1
141,11,11,11,11,1,1,1,1,1,1
142,11,11,11,11,1,1,1,1,1,1
143,11,11,11,11,1,1,1,1,1,1
144,12,12,12,12,1,1,1,1,1,1
145,12,12,12,12,1,1,1,1,1,1
146,12,12,12,12,1,1,1,1,1,1
147,12,12,12,12,1,1,1,1,1,1
148,12,12,12,12,1,1,1,1,1,1
149,12,12,12,12,1,1,1,1,1,1
150,12,12,12,12,1,1,1,1,1,1
151,12,12,12,12,1,1,1,1,1,1
152,12,12,12,12,1,1,1,1,1,1
153,12,14,14,14,0,0,0,1,1,1
154,12,12,12,12,1,1,1,1,1,1
155,12,12,12,12,1,1,1,1,1,1
156,13,13,13,13,1,1,1,1,1,1
157,13,13,13,13,1,1,1,1,1,1
158,13,13,13,13,1,1,1,1,1,1
159,13,13,13,13,1,1,1,1,1,1
160,13,13,13,13,1,1,1,1,1,1
161,13,13,13,13,1,1,1,1,1,1
162,13,13,13,13,1,1,1,1,1,1
163,13,13,13,13,1,1,1,1,1,1
164,13,13,13,13,1,1,1,1,1,1
165,13,13,13,13,1,1,1,1,1,1
166,13,13,13,13,1,1,1,1,1,1
167,13,13,13,13,1,1,1,1,1,1
168,14,14,14,14,1,1,1,1,1,1
169,14,14,14,14,1,1,1,1,1,1
170,14,14,14,14,1,1,1,1,1,1
171,14,14,14,14,1,1,1,1,1,1
172,14,14,14,14,1,1,1,1,1,1
173,14,14,14,14,1,1,1,1,1,1
174,14,14,14,14,1,1,1,1,1,1
175,14,14,14,14,1,1,1,1,1,1
176,14,14,14,14,1,1,1,1,1,1
177,14,14,14,14,1,1,1,1,1,1
178,14,14,14,14,1,1,1,1,1,1
179,14,14,14,14,1,1,1,1,1,1
