sample_index,label,base_pred,local_pred,final_pred,base_correct,local_correct,final_correct,base_local_agree,base_final_agree,local_final_agree
0,3,3,3,3,1,1,1,1,1,1
1,4,4,3,4,1,0,1,0,1,0
2,5,2,0,2,0,0,0,0,1,0
3,0,2,0,2,0,1,0,0,1,0
4,3,3,3,3,1,1,1,1,1,1
5,2,2,0,2,1,0,1,0,1,0
6,1,2,3,2,0,0,0,0,1,0
7,2,2,0,2,1,0,1,0,1,0
8,2,2,0,2,1,0,1,0,1,0
9,0,2,0,2,0,1,0,0,1,0
10,4,4,3,3,1,0,0,0,0,1
11,3,3,3,3,1,1,1,1,1,1
12,2,2,2,2,1,1,1,1,1,1
13,4,4,3,4,1,0,1,0,1,0
14,1,2,2,2,0,0,0,1,1,1
15,0,2,0,2,0,1,0,0,1,0
16,4,3,3,3,0,0,0,1,1,1
17,0,2,0,2,0,1,0,0,1,0
18,4,4,3,3,1,0,0,0,0,1
19,0,2,0,2,0,1,0,0,1,0
20,2,2,2,2,1,1,1,1,1,1
21,3,3,3,3,1,1,1,1,1,1
22,5,2,0,2,0,0,0,0,1,0
23,5,5,0,5,1,0,1,0,1,0
24,1,2,2,2,0,0,0,1,1,1
25,2,4,0,4,0,0,0,0,1,0
26,1,2,2,2,0,0,0,1,1,1
27,0,2,0,2,0,1,0,0,1,0
28,1,2,2,2,0,0,0,1,1,1
29,4,3,3,3,0,0,0,1,1,1
30,2,2,0,2,1,0,1,0,1,0
31,3,3,3,3,1,1,1,1,1,1
32,5,2,0,2,0,0,0,0,1,0
33,4,4,3,4,1,0,1,0,1,0
34,3,3,3,3,1,1,1,1,1,1
35,5,2,2,2,0,0,0,1,1,1
36,3,3,3,3,1,1,1,1,1,1
37,0,2,0,2,0,1,0,0,1,0
38,3,4,3,3,0,1,1,0,0,1
39,5,2,0,2,0,0,0,0,1,0
40,4,4,3,3,1,0,0,0,0,1
41,2,2,0,2,1,0,1,0,1,0
42,1,2,0,2,0,0,0,0,1,0
43,5,5,3,2,1,0,0,0,0,0
44,0,2,0,2,0,1,0,0,1,0
45,2,2,2,2,1,1,1,1,1,1
46,4,3,3,3,0,0,0,1,1,1
47,3,4,3,4,0,1,0,0,1,0
48,2,2,2,2,1,1,1,1,1,1
49,2,2,0,2,1,0,1,0,1,0
50,2,2,2,2,1,1,1,1,1,1
51,2,2,0,2,1,0,1,0,1,0
52,0,2,2,2,0,0,0,1,1,1
53,2,2,2,2,1,1,1,1,1,1
54,0,2,0,2,0,1,0,0,1,0
55,1,2,2,2,0,0,0,1,1,1
56,0,2,0,2,0,1,0,0,1,0
57,0,2,0,2,0,1,0,0,1,0
58,4,4,3,4,1,0,1,0,1,0
59,1,2,2,2,0,0,0,1,1,1
60,4,3,3,3,0,0,0,1,1,1
61,5,5,0,4,1,0,0,0,0,0
62,0,2,0,2,0,1,0,0,1,0
63,5,2,0,2,0,0,0,0,1,0
64,1,2,0,2,0,0,0,0,1,0
65,1,2,2,2,0,0,0,1,1,1
66,1,2,2,2,0,0,0,1,1,1
67,2,2,0,2,1,0,1,0,1,0
68,4,4,3,3,1,0,0,0,0,1
69,1,2,0,2,0,0,0,0,1,0
70,5,2,0,2,0,0,0,0,1,0
71,3,3,3,3,1,1,1,1,1,1
72,0,2,0,2,0,1,0,0,1,0
73,3,3,3,3,1,1,1,1,1,1
74,4,3,3,3,0,0,0,1,1,1
75,3,3,3,3,1,1,1,1,1,1
76,1,2,0,2,0,0,0,0,1,0
77,4,4,3,3,1,0,0,0,0,1
78,4,3,3,3,0,0,0,1,1,1
79,2,2,2,2,1,1,1,1,1,1
80,0,2,0,2,0,1,0,0,1,0
81,3,3,3,3,1,1,1,1,1,1
82,3,4,3,3,0,1,1,0,0,1
83,5,2,3,2,0,0,0,0,1,0
84,1,2,2,2,0,0,0,1,1,1
85,5,5,0,5,1,0,1,0,1,0
86,2,2,0,2,1,0,1,0,1,0
87,5,2,0,2,0,0,0,0,1,0
88,5,2,0,2,0,0,0,0,1,0
89,4,4,3,4,1,0,1,0,1,0
90,4,4,3,3,1,0,0,0,0,1
91,2,2,2,2,1,1,1,1,1,1
92,4,4,3,4,1,0,1,0,1,0
93,3,4,3,4,0,1,0,0,1,0
94,5,2,0,2,0,0,0,0,1,0
95,2,2,2,2,1,1,1,1,1,1
96,1,2,0,2,0,0,0,0,1,0
97,5,2,0,2,0,0,0,0,1,0
98,0,2,0,2,0,1,0,0,1,0
99,3,4,3,3,0,1,1,0,0,1
100,0,2,0,2,0,1,0,0,1,0
101,5,2,0,2,0,0,0,0,1,0
102,3,3,3,3,1,1,1,1,1,1
103,5,2,3,2,0,0,0,0,1,0
104,0,2,0,2,0,1,0,0,1,0
105,5,2,0,2,0,0,0,0,1,0
106,5,2,0,2,0,0,0,0,1,0
107,0,2,0,2,0,1,0,0,1,0
108,2,4,0,4,0,0,0,0,1,0
109,5,2,3,2,0,0,0,0,1,0
110,0,2,0,2,0,1,0,0,1,0
111,1,2,2,2,0,0,0,1,1,1
112,1,2,2,2,0,0,0,1,1,1
113,4,3,3,3,0,0,0,1,1,1
114,1,2,2,2,0,0,0,1,1,1
115,0,2,0,2,0,1,0,0,1,0
116,0,4,0,4,0,1,0,0,1,0
117,2,2,2,2,1,1,1,1,1,1
118,4,3,3,3,0,0,0,1,1,1
119,1,2,2,2,0,0,0,1,1,1
120,0,2,0,2,0,1,0,0,1,0
121,3,3,3,3,1,1,1,1,1,1
122,4,3,3,3,0,0,0,1,1,1
123,3,4,3,3,0,1,1,0,0,1
124,1,2,2,2,0,0,0,1,1,1
125,2,4,0,2,0,0,1,0,0,0
126,2,2,0,2,1,0,1,0,1,0
127,2,2,0,2,1,0,1,0,1,0
128,2,2,0,2,1,0,1,0,1,0
129,0,2,0,2,0,1,0,0,1,0
130,4,4,3,4,1,0,1,0,1,0
131,0,2,0,2,0,1,0,0,1,0
132,0,2,3,2,0,0,0,0,1,0
133,1,2,0,2,0,0,0,0,1,0
134,3,3,2,3,1,0,1,0,1,0
135,4,4,3,4,1,0,1,0,1,0
136,4,4,3,3,1,0,0,0,0,1
137,2,2,0,2,1,0,1,0,1,0
138,1,2,2,2,0,0,0,1,1,1
139,1,4,0,4,0,0,0,0,1,0
140,1,2,0,2,0,0,0,0,1,0
141,4,3,3,3,0,0,0,1,1,1
142,4,3,3,3,0,0,0,1,1,1
143,3,3,3,3,1,1,1,1,1,1
144,1,2,0,2,0,0,0,0,1,0
145,4,3,3,3,0,0,0,1,1,1
146,0,2,2,2,0,0,0,1,1,1
147,4,3,3,3,0,0,0,1,1,1
148,5,5,0,5,1,0,1,0,1,0
149,5,2,2,2,0,0,0,1,1,1
150,1,2,2,2,0,0,0,1,1,1
151,5,5,0,5,1,0,1,0,1,0
152,3,3,3,3,1,1,1,1,1,1
153,3,3,3,3,1,1,1,1,1,1
154,5,5,0,2,1,0,0,0,0,0
155,5,2,0,2,0,0,0,0,1,0
156,4,3,3,3,0,0,0,1,1,1
157,3,3,3,3,1,1,1,1,1,1
158,5,2,2,2,0,0,0,1,1,1
159,1,2,2,2,0,0,0,1,1,1
160,3,3,2,3,1,0,1,0,1,0
161,2,2,2,2,1,1,1,1,1,1
162,3,3,3,3,1,1,1,1,1,1
163,0,2,0,2,0,1,0,0,1,0
164,1,2,0,2,0,0,0,0,1,0
165,3,3,3,3,1,1,1,1,1,1
166,0,2,0,2,0,1,0,0,1,0
167,2,2,2,2,1,1,1,1,1,1
168,5,2,0,2,0,0,0,0,1,0
169,2,2,0,2,1,0,1,0,1,0
170,1,2,2,2,0,0,0,1,1,1
171,5,5,0,2,1,0,0,0,0,0
172,3,3,3,3,1,1,1,1,1,1
173,1,2,0,2,0,0,0,0,1,0
174,0,2,2,2,0,0,0,1,1,1
175,5,2,2,2,0,0,0,1,1,1
176,2,2,2,2,1,1,1,1,1,1
177,4,3,3,3,0,0,0,1,1,1
178,3,3,3,3,1,1,1,1,1,1
179,3,3,3,3,1,1,1,1,1,1
