sample_index,label,base_pred,local_pred,final_pred,base_correct,local_correct,final_correct,base_local_agree,base_final_agree,local_final_agree
0,0,0,1,0,1,0,1,0,1,0
1,0,0,0,0,1,1,1,1,1,1
2,0,0,0,0,1,1,1,1,1,1
3,0,0,1,0,1,0,1,0,1,0
4,0,1,1,1,0,0,0,1,1,1
5,0,0,1,0,1,0,1,0,1,0
6,0,0,1,0,1,0,1,0,1,0
7,0,1,1,1,0,0,0,1,1,1
8,0,0,0,0,1,1,1,1,1,1
9,0,0,1,0,1,0,1,0,1,0
10,0,0,0,0,1,1,1,1,1,1
11,0,0,0,0,1,1,1,1,1,1
12,0,0,1,0,1,0,1,0,1,0
13,0,1,1,1,0,0,0,1,1,1
14,0,1,1,1,0,0,0,1,1,1
15,0,0,0,0,1,1,1,1,1,1
16,0,0,0,0,1,1,1,1,1,1
17,0,0,1,0,1,0,1,0,1,0
18,0,0,0,0,1,1,1,1,1,1
19,0,1,1,1,0,0,0,1,1,1
20,0,0,1,0,1,0,1,0,1,0
21,0,0,0,0,1,1,1,1,1,1
22,0,1,1,1,0,0,0,1,1,1
23,0,0,0,0,1,1,1,1,1,1
24,0,1,1,1,0,0,0,1,1,1
25,0,1,1,1,0,0,0,1,1,1
26,0,0,0,0,1,1,1,1,1,1
27,0,0,0,0,1,1,1,1,1,1
28,0,0,0,0,1,1,1,1,1,1
29,0,0,0,0,1,1,1,1,1,1
30,0,1,1,1,0,0,0,1,1,1
31,0,1,1,1,0,0,0,1,1,1
32,0,0,0,0,1,1,1,1,1,1
33,0,0,0,0,1,1,1,1,1,1
34,0,0,0,0,1,1,1,1,1,1
35,0,0,0,0,1,1,1,1,1,1
36,0,0,0,0,1,1,1,1,1,1
37,0,0,0,0,1,1,1,1,1,1
38,0,0,1,1,1,0,0,0,0,1
39,0,1,1,1,0,0,0,1,1,1
40,0,0,0,0,1,1,1,1,1,1
41,0,0,1,0,1,0,1,0,1,0
42,0,0,0,0,1,1,1,1,1,1
43,0,0,1,0,1,0,1,0,1,0
44,0,0,1,0,1,0,1,0,1,0
45,0,0,0,0,1,1,1,1,1,1
46,0,0,1,0,1,0,1,0,1,0
47,0,0,1,0,1,0,1,0,1,0
48,0,0,0,0,1,1,1,1,1,1
49,0,0,0,0,1,1,1,1,1,1
50,0,1,1,1,0,0,0,1,1,1
51,0,0,1,0,1,0,1,0,1,0
52,0,0,1,1,1,0,0,0,0,1
53,0,1,1,1,0,0,0,1,1,1
54,0,1,1,1,0,0,0,1,1,1
55,0,0,0,0,1,1,1,1,1,1
56,0,1,1,1,0,0,0,1,1,1
57,1,0,0,0,0,0,0,1,1,1
58,1,0,0,0,0,0,0,1,1,1
59,1,0,0,0,0,0,0,1,1,1
60,1,0,0,0,0,0,0,1,1,1
61,1,1,1,1,1,1,1,1,1,1
62,1,1,1,1,1,1,1,1,1,1
63,1,0,0,0,0,0,0,1,1,1
64,1,0,0,0,0,0,0,1,1,1
65,1,0,1,0,0,1,0,0,1,0
66,1,1,1,1,1,1,1,1,1,1
67,1,1,1,1,1,1,1,1,1,1
68,1,0,1,0,0,1,0,0,1,0
69,1,1,1,1,1,1,1,1,1,1
70,1,1,1,1,1,1,1,1,1,1
71,1,1,1,1,1,1,1,1,1,1
72,1,1,1,1,1,1,1,1,1,1
73,1,0,1,0,0,1,0,0,1,0
74,1,1,1,1,1,1,1,1,1,1
75,1,1,1,1,1,1,1,1,1,1
76,1,0,1,1,0,1,1,0,0,1
77,1,1,1,1,1,1,1,1,1,1
78,1,0,0,0,0,0,0,1,1,1
79,1,0,1,0,0,1,0,0,1,0
80,1,0,0,0,0,0,0,1,1,1
81,1,1,1,1,1,1,1,1,1,1
82,1,1,1,1,1,1,1,1,1,1
83,1,0,1,0,0,1,0,0,1,0
84,1,1,1,1,1,1,1,1,1,1
85,1,0,1,1,0,1,1,0,0,1
86,1,1,1,1,1,1,1,1,1,1
87,1,1,1,1,1,1,1,1,1,1
88,1,1,1,1,1,1,1,1,1,1
89,1,1,1,1,1,1,1,1,1,1
90,1,1,1,1,1,1,1,1,1,1
91,1,1,1,1,1,1,1,1,1,1
92,1,0,0,0,0,0,0,1,1,1
93,1,0,0,0,0,0,0,1,1,1
94,1,0,0,0,0,0,0,1,1,1
95,1,0,1,0,0,1,0,0,1,0
96,1,0,1,0,0,1,0,0,1,0
97,1,1,1,1,1,1,1,1,1,1
98,1,1,1,1,1,1,1,1,1,1
99,1,0,1,0,0,1,0,0,1,0
100,1,1,1,1,1,1,1,1,1,1
101,1,0,1,0,0,1,0,0,1,0
102,1,1,1,1,1,1,1,1,1,1
103,1,1,1,1,1,1,1,1,1,1
104,1,0,0,0,0,0,0,1,1,1
105,1,0,0,0,0,0,0,1,1,1
106,1,0,0,0,0,0,0,1,1,1
107,1,0,1,1,0,1,1,0,0,1
108,1,1,1,1,1,1,1,1,1,1
109,1,1,1,1,1,1,1,1,1,1
110,1,0,0,0,0,0,0,1,1,1
111,1,1,1,1,1,1,1,1,1,1
112,1,0,0,0,0,0,0,1,1,1
113,1,1,1,1,1,1,1,1,1,1
114,1,0,0,0,0,0,0,1,1,1
115,1,0,0,0,0,0,0,1,1,1
116,1,1,1,1,1,1,1,1,1,1
117,1,0,1,0,0,1,0,0,1,0
118,1,1,1,1,1,1,1,1,1,1
119,1,0,0,0,0,0,0,1,1,1
120,1,0,0,0,0,0,0,1,1,1
121,1,0,1,0,0,1,0,0,1,0
122,1,0,0,0,0,0,0,1,1,1
123,1,1,1,1,1,1,1,1,1,1
124,1,0,0,0,0,0,0,1,1,1
125,1,0,0,0,0,0,0,1,1,1
126,1,1,1,1,1,1,1,1,1,1
127,1,1,1,1,1,1,1,1,1,1
128,1,1,1,1,1,1,1,1,1,1
129,1,1,1,1,1,1,1,1,1,1
130,1,0,0,0,0,0,0,1,1,1
131,1,1,1,1,1,1,1,1,1,1
132,1,1,1,1,1,1,1,1,1,1
133,1,1,1,1,1,1,1,1,1,1
134,1,0,0,0,0,0,0,1,1,1
135,1,1,1,1,1,1,1,1,1,1
136,1,0,0,0,0,0,0,1,1,1
137,1,0,0,0,0,0,0,1,1,1
138,1,0,1,0,0,1,0,0,1,0
139,1,1,1,1,1,1,1,1,1,1
140,1,0,0,0,0,0,0,1,1,1
141,1,0,0,0,0,0,0,1,1,1
142,1,0,0,0,0,0,0,1,1,1
143,1,0,1,0,0,1,0,0,1,0
144,1,1,1,1,1,1,1,1,1,1
145,1,0,1,0,0,1,0,0,1,0
146,1,1,1,1,1,1,1,1,1,1
147,1,0,0,0,0,0,0,1,1,1
148,1,1,1,1,1,1,1,1,1,1
149,1,1,1,1,1,1,1,1,1,1
150,1,0,0,0,0,0,0,1,1,1
151,1,1,1,1,1,1,1,1,1,1
152,1,1,1,1,1,1,1,1,1,1
153,1,1,1,1,1,1,1,1,1,1
154,1,1,1,1,1,1,1,1,1,1
155,1,1,1,1,1,1,1,1,1,1
156,1,1,1,1,1,1,1,1,1,1
157,1,1,1,1,1,1,1,1,1,1
158,1,1,1,1,1,1,1,1,1,1
159,1,0,1,0,0,1,0,0,1,0
160,1,1,1,1,1,1,1,1,1,1
161,1,1,1,1,1,1,1,1,1,1
162,1,1,1,1,1,1,1,1,1,1
163,1,1,1,1,1,1,1,1,1,1
164,1,1,1,1,1,1,1,1,1,1
165,1,1,1,1,1,1,1,1,1,1
166,1,1,1,1,1,1,1,1,1,1
167,1,0,0,0,0,0,0,1,1,1
168,1,0,1,1,0,1,1,0,0,1
169,1,0,0,0,0,0,0,1,1,1
170,1,1,1,1,1,1,1,1,1,1
171,1,1,1,1,1,1,1,1,1,1
172,1,0,1,1,0,1,1,0,0,1
173,1,1,1,1,1,1,1,1,1,1
174,1,1,1,1,1,1,1,1,1,1
175,1,0,1,0,0,1,0,0,1,0
176,1,0,1,0,0,1,0,0,1,0
177,1,0,0,0,0,0,0,1,1,1
178,1,1,1,1,1,1,1,1,1,1
179,1,0,1,0,0,1,0,0,1,0
180,1,0,1,0,0,1,0,0,1,0
181,1,0,0,0,0,0,0,1,1,1
182,1,0,0,0,0,0,0,1,1,1
183,1,0,0,0,0,0,0,1,1,1
184,1,0,0,0,0,0,0,1,1,1
185,1,0,1,0,0,1,0,0,1,0
186,1,1,1,1,1,1,1,1,1,1
187,1,1,1,1,1,1,1,1,1,1
188,1,1,1,1,1,1,1,1,1,1
189,1,1,1,1,1,1,1,1,1,1
190,1,0,0,0,0,0,0,1,1,1
191,1,1,1,1,1,1,1,1,1,1
192,1,1,1,1,1,1,1,1,1,1
193,1,1,1,1,1,1,1,1,1,1
194,1,1,1,1,1,1,1,1,1,1
195,1,0,0,0,0,0,0,1,1,1
196,1,0,0,0,0,0,0,1,1,1
197,1,0,0,0,0,0,0,1,1,1
198,1,1,1,1,1,1,1,1,1,1
199,1,1,1,1,1,1,1,1,1,1
200,1,0,0,0,0,0,0,1,1,1
201,1,1,1,1,1,1,1,1,1,1
202,1,0,0,0,0,0,0,1,1,1
203,1,1,1,1,1,1,1,1,1,1
204,1,0,0,0,0,0,0,1,1,1
